Novel of size 1: +word_boundary	#
Novel of size 1: -word_boundary	AA,AE,AH,AO,B,CH,D,DH,EH,ER,EY,F,G,HH,IH,IY,JH,K,L,M,N,NG,OW,P,R,S,SH,T,TH,UH,UW,V,W,Y,Z,ZH
Novel of size 2: +sonorant,-round	AA,AE,AH,EH,ER,EY,IH,IY,L,M,N,NG,R,Y
Novel of size 1: +continuant	AA,AE,AH,AO,DH,EH,ER,EY,F,HH,IH,IY,L,OW,R,S,SH,TH,UH,UW,V,W,Y,Z,ZH
Novel of size 3: -low,-front,+syllabic	AH,AO,ER,OW,UH,UW
Novel of size 2: +low,-front	AA
Novel of size 4: -spread_glottis,-round,-lateral,-syllabic	B,CH,D,DH,F,G,JH,K,M,N,NG,P,R,S,SH,T,TH,V,Y,Z,ZH
Novel of size 2: +low,+front	AE
Novel of size 3: -labial,-low,+back	AH
Novel of size 3: +consonantal,+voice,-labial	D,DH,G,JH,L,N,NG,Z,ZH
Novel of size 3: -spread_glottis,-labiodental,-syllabic	B,CH,D,DH,G,JH,K,L,M,N,NG,P,R,S,SH,T,TH,W,Y,Z,ZH
Novel of size 3: +continuant,-round,-lateral	AA,AE,AH,DH,EH,ER,EY,F,HH,IH,IY,R,S,SH,TH,V,Y,Z,ZH
Novel of size 3: +labial,-high,-tense	AO
Novel of size 3: -spread_glottis,-round,-coronal	AA,AE,AH,B,EH,EY,F,G,IH,IY,K,M,NG,P,V,Y
Novel of size 3: +voice,+labial,-labiodental	AO,B,M,OW,UH,UW,W
Novel of size 2: -consonantal,+high	IH,IY,UH,UW,W,Y
Novel of size 3: -nasal,+labial,-labiodental	AO,B,OW,P,UH,UW,W
Novel of size 2: -labiodental,-coronal	AA,AE,AH,AO,B,EH,EY,G,HH,IH,IY,K,M,NG,OW,P,UH,UW,W,Y
Novel of size 3: -nasal,+voice,+labial	AO,B,OW,UH,UW,V,W
Novel of size 2: +continuant,+labial	AO,F,OW,UH,UW,V,W
Novel of size 2: -front,+syllabic	AA,AH,AO,ER,OW,UH,UW
Novel of size 3: -delayed_release,+voice,+labial	B
Novel of size 1: +low	AA,AE
Novel of size 3: -delayed_release,+voice,+coronal	D
Novel of size 2: -voice,+labiodental	F
Novel of size 2: -labial,+back	AA,AH
Novel of size 3: -sonorant,+voice,+dorsal	G
Novel of size 2: -voice,+dorsal	K
Novel of size 1: +lateral	L
Novel of size 2: +nasal,+labial	M
Novel of size 2: +nasal,+coronal	N
Novel of size 3: -continuant,-voice,+labial	P
Novel of size 2: -consonantal,-anterior	R
Novel of size 3: +continuant,-voice,-distributed	S
Novel of size 3: -continuant,-voice,+anterior	T
Novel of size 3: -high,+back,-tense	AH,AO
Novel of size 2: +voice,+labiodental	V
Novel of size 2: +round,-syllabic	W
Novel of size 2: +front,-syllabic	Y
Novel of size 3: +delayed_release,+voice,-distributed	Z
Novel of size 3: -continuant,+delayed_release,-voice	CH
Novel of size 3: -approximant,+voice,-labiodental	B,D,DH,G,JH,M,N,NG,Z,ZH
Novel of size 3: -spread_glottis,-round,-syllabic	B,CH,D,DH,F,G,JH,K,L,M,N,NG,P,R,S,SH,T,TH,V,Y,Z,ZH
Novel of size 2: -low,-front	AH,AO,ER,OW,UH,UW,W
Novel of size 1: -approximant	B,CH,D,DH,F,G,HH,JH,K,M,N,NG,P,S,SH,T,TH,V,Z,ZH
Novel of size 2: +continuant,-round	AA,AE,AH,DH,EH,ER,EY,F,HH,IH,IY,L,R,S,SH,TH,V,Y,Z,ZH
Novel of size 3: -spread_glottis,-lateral,-syllabic	B,CH,D,DH,F,G,JH,K,M,N,NG,P,R,S,SH,T,TH,V,W,Y,Z,ZH
Novel of size 3: +consonantal,+continuant,+distributed	DH,SH,TH,ZH
Novel of size 3: -nasal,+voice,+high	G,IH,IY,UH,UW,W,Y
Novel of size 2: +labial,-labiodental	AO,B,M,OW,P,UH,UW,W
Novel of size 3: +delayed_release,+voice,-strident	DH
Novel of size 3: -delayed_release,+voice,-dorsal	B,D
Novel of size 4: -round,-labiodental,-lateral,-syllabic	B,CH,D,DH,G,HH,JH,K,M,N,NG,P,R,S,SH,T,TH,Y,Z,ZH
Novel of size 2: +voice,+labial	AO,B,M,OW,UH,UW,V,W
Novel of size 4: +voice,-labial,-lateral,-syllabic	D,DH,G,JH,N,NG,R,Y,Z,ZH
Novel of size 3: -delayed_release,+voice,-coronal	B,G
Novel of size 3: -delayed_release,+voice,-labial	D,G
Novel of size 3: -continuant,+voice,+labial	B,M
Novel of size 4: -nasal,+voice,-distributed,-strident	D,L
Novel of size 2: -sonorant,+dorsal	G,K
Novel of size 2: -delayed_release,+labial	B,P
Novel of size 3: -continuant,+voice,+anterior	D,N
Novel of size 3: -round,-labiodental,-coronal	AA,AE,AH,B,EH,EY,G,HH,IH,IY,K,M,NG,P,Y
Novel of size 1: -front	AA,AH,AO,ER,OW,UH,UW,W
Novel of size 2: -voice,+labial	F,P
Novel of size 2: -delayed_release,+coronal	D,T
Novel of size 3: -sonorant,+voice,+labial	B,V
Novel of size 5: -nasal,+voice,+labial,-labiodental,-syllabic	B,W
Novel of size 2: +sonorant,-distributed	L,N
Novel of size 2: +nasal,-dorsal	M,N
Novel of size 3: -continuant,-voice,-coronal	K,P
Novel of size 1: +labiodental	F,V
Novel of size 2: +approximant,-dorsal	L,R
Novel of size 3: -sonorant,+voice,-distributed	D,Z
Novel of size 3: -delayed_release,-voice,-labial	K,T
Novel of size 4: +sonorant,-labial,-lateral,-dorsal	N,R
Novel of size 5: -nasal,+voice,-labial,-coronal,-syllabic	G,Y
Novel of size 3: -high,+front,-tense	EH
Novel of size 3: +sonorant,+labial,-syllabic	M,W
Novel of size 3: -delayed_release,-voice,-dorsal	P,T
Novel of size 3: +continuant,+voice,-distributed	L,Z
Novel of size 2: -voice,-distributed	S,T
Novel of size 4: -consonantal,+sonorant,-labial,-syllabic	R,Y
Novel of size 2: -consonantal,+anterior	ER
Novel of size 2: +delayed_release,-distributed	S,Z
Novel of size 4: +continuant,+voice,+labial,-syllabic	V,W
Novel of size 5: +continuant,+voice,-round,-coronal,-syllabic	V,Y
Novel of size 2: +tense,-syllabic	W,Y
Novel of size 3: -labial,-high,+tense	EY
Novel of size 3: +consonantal,+voice,-labiodental	B,D,DH,G,JH,L,M,N,NG,Z,ZH
Novel of size 3: -continuant,-voice,+coronal	CH,T
Novel of size 2: -approximant,+voice	B,D,DH,G,JH,M,N,NG,V,Z,ZH
Novel of size 2: -spread_glottis,-syllabic	B,CH,D,DH,F,G,JH,K,L,M,N,NG,P,R,S,SH,T,TH,V,W,Y,Z,ZH
Novel of size 2: -nasal,+high	G,IH,IY,K,UH,UW,W,Y
Novel of size 3: -sonorant,+voice,-strident	D,DH
Novel of size 4: -labial,-coronal,-high,-tense	AH,EH
Novel of size 2: -delayed_release,+voice	B,D,G
Novel of size 3: +continuant,+distributed,-dorsal	DH,R,SH,TH,ZH
Novel of size 2: -nasal,+labial	AO,B,F,OW,P,UH,UW,V,W
Novel of size 4: +consonantal,+continuant,+voice,-strident	DH,L
Novel of size 1: -coronal	AA,AE,AH,AO,B,EH,EY,F,G,HH,IH,IY,K,M,NG,OW,P,UH,UW,V,W,Y
Novel of size 3: -round,-labiodental,-syllabic	B,CH,D,DH,G,HH,JH,K,L,M,N,NG,P,R,S,SH,T,TH,Y,Z,ZH
Novel of size 3: +voice,-labial,-syllabic	D,DH,G,JH,L,N,NG,R,Y,Z,ZH
Novel of size 3: -labial,-low,-front	AH,ER
Novel of size 4: +voice,+distributed,-strident,-dorsal	DH,R
Novel of size 3: -labiodental,-lateral,-syllabic	B,CH,D,DH,G,HH,JH,K,M,N,NG,P,R,S,SH,T,TH,W,Y,Z,ZH
Novel of size 3: +delayed_release,+voice,+anterior	DH,Z
Novel of size 3: +voice,-distributed,-strident	D,L,N
Novel of size 2: -continuant,+labial	B,M,P
Novel of size 3: -sonorant,+voice,-coronal	B,G,V
Novel of size 3: +consonantal,-voice,-coronal	F,K,P
Novel of size 6: -nasal,+voice,-round,-labiodental,-coronal,-syllabic	B,G,Y
Novel of size 3: -nasal,-distributed,-strident	D,L,T
Novel of size 3: +consonantal,+voice,+labial	B,M,V
Novel of size 2: -continuant,+anterior	D,N,T
Novel of size 4: +voice,+labial,-labiodental,-syllabic	B,M,W
Novel of size 3: +consonantal,+sonorant,-dorsal	L,M,N
Novel of size 4: -nasal,+labial,-labiodental,-syllabic	B,P,W
Novel of size 3: -nasal,+voice,-distributed	D,L,Z
Novel of size 4: -nasal,-labial,+dorsal,-syllabic	G,K,Y
Novel of size 3: +sonorant,-labial,-dorsal	L,N,R
Novel of size 3: -approximant,+voice,-distributed	D,N,Z
Novel of size 3: +sonorant,-lateral,-dorsal	M,N,R
Novel of size 2: -delayed_release,-voice	K,P,T
Novel of size 4: -nasal,+voice,+labial,-syllabic	B,V,W
Novel of size 3: +continuant,+labial,-syllabic	F,V,W
Novel of size 2: -labial,-front	AA,AH,ER
Novel of size 5: +continuant,-spread_glottis,-round,-coronal,-syllabic	F,V,Y
Novel of size 3: +approximant,-labial,-syllabic	L,R,Y
Novel of size 4: -nasal,+voice,+dorsal,-syllabic	G,W,Y
Novel of size 3: -coronal,-high,-tense	AH,AO,EH
Novel of size 2: +continuant,-distributed	L,S,Z
Novel of size 2: +approximant,+anterior	ER,L
Novel of size 3: +sonorant,+anterior,-lateral	ER,N
Novel of size 2: -consonantal,+coronal	ER,R
Novel of size 1: +spread_glottis	HH
Novel of size 3: -consonantal,+sonorant,-syllabic	R,W,Y
Novel of size 3: -high,-front,-tense	AH,AO,ER
Novel of size 3: -continuant,-voice,-labial	CH,K,T
Novel of size 4: +continuant,+voice,-coronal,-syllabic	V,W,Y
Novel of size 3: -continuant,-voice,-dorsal	CH,P,T
Novel of size 2: +consonantal,+voice	B,D,DH,G,JH,L,M,N,NG,V,Z,ZH
Novel of size 4: +consonantal,-nasal,+voice,-strident	D,DH,L
Novel of size 3: -approximant,+voice,-strident	D,DH,N
Novel of size 5: +voice,-round,-labiodental,-lateral,-syllabic	B,D,DH,G,JH,M,N,NG,R,Y,Z,ZH
Novel of size 4: +continuant,+voice,-labiodental,-lateral	AA,AE,AH,AO,DH,EH,ER,EY,IH,IY,OW,R,UH,UW,W,Y,Z,ZH
Novel of size 5: -nasal,+voice,-strident,-lateral,-dorsal	D,DH,R
Novel of size 1: +labial	AO,B,F,M,OW,P,UH,UW,V,W
Novel of size 3: -labial,+high,-tense	IH
Novel of size 3: -sonorant,+voice,+anterior	D,DH,Z
Novel of size 3: -round,-lateral,-syllabic	B,CH,D,DH,F,G,HH,JH,K,M,N,NG,P,R,S,SH,T,TH,V,Y,Z,ZH
Novel of size 4: +continuant,+voice,-strident,-dorsal	DH,L,R
Novel of size 2: -delayed_release,-coronal	B,G,K,P
Novel of size 3: -sonorant,+continuant,+coronal	DH,S,SH,TH,Z,ZH
Novel of size 2: -labiodental,-syllabic	B,CH,D,DH,G,HH,JH,K,L,M,N,NG,P,R,S,SH,T,TH,W,Y,Z,ZH
Novel of size 2: -delayed_release,-labial	D,G,K,T
Novel of size 2: -delayed_release,-dorsal	B,D,P,T
Novel of size 4: +consonantal,+continuant,+voice,+anterior	DH,L,Z
Novel of size 2: -sonorant,+labial	B,F,P,V
Novel of size 2: -round,-coronal	AA,AE,AH,B,EH,EY,F,G,HH,IH,IY,K,M,NG,P,V,Y
Novel of size 4: -labial,+high,+tense,+syllabic	IY
Novel of size 3: +voice,+anterior,+distributed	DH,ER
Novel of size 2: -distributed,-strident	D,L,N,T
Novel of size 3: +labial,-labiodental,-syllabic	B,M,P,W
Novel of size 2: +voice,-distributed	D,L,N,Z
Novel of size 5: -nasal,+voice,-round,-coronal,-syllabic	B,G,V,Y
Novel of size 2: +sonorant,-dorsal	L,M,N,R
Novel of size 5: -nasal,+voice,-labiodental,-coronal,-syllabic	B,G,W,Y
Novel of size 3: +voice,+labial,-syllabic	B,M,V,W
Novel of size 3: -continuant,+delayed_release,+voice	JH
Novel of size 3: -nasal,+dorsal,-syllabic	G,K,W,Y
Novel of size 2: -sonorant,-distributed	D,S,T,Z
Novel of size 3: +continuant,-voice,-coronal	F,HH
Novel of size 2: +sonorant,+anterior	ER,L,N
Novel of size 2: +approximant,+coronal	ER,L,R
Novel of size 3: -voice,-labial,-coronal	HH,K
Novel of size 4: +continuant,-spread_glottis,-coronal,-syllabic	F,V,W,Y
Novel of size 3: +sonorant,+coronal,-lateral	ER,N,R
Novel of size 2: +approximant,-syllabic	L,R,W,Y
Novel of size 3: -high,-back,-tense	EH,ER
Novel of size 4: -voice,-labiodental,-coronal,-dorsal	HH,P
Novel of size 2: -consonantal,-dorsal	HH,R
Novel of size 2: -continuant,-voice	CH,K,P,T
Novel of size 3: -high,-low,+front	EH,EY
Novel of size 4: -consonantal,-labial,-coronal,-syllabic	HH,Y
Novel of size 4: -nasal,-spread_glottis,-labial,-lateral	AA,AE,AH,CH,D,DH,EH,ER,EY,G,IH,IY,JH,K,R,S,SH,T,TH,Y,Z,ZH
Novel of size 3: +consonantal,+voice,-strident	D,DH,L,N
Novel of size 4: +voice,-round,-labiodental,-syllabic	B,D,DH,G,JH,L,M,N,NG,R,Y,Z,ZH
Novel of size 3: +continuant,+voice,-labiodental	AA,AE,AH,AO,DH,EH,ER,EY,IH,IY,L,OW,R,UH,UW,W,Y,Z,ZH
Novel of size 4: -nasal,+voice,-strident,-dorsal	D,DH,L,R
Novel of size 4: +voice,-strident,-lateral,-dorsal	D,DH,N,R
Novel of size 4: +voice,-round,-lateral,-syllabic	B,D,DH,G,JH,M,N,NG,R,V,Y,Z,ZH
Novel of size 3: +continuant,+voice,-lateral	AA,AE,AH,AO,DH,EH,ER,EY,IH,IY,OW,R,UH,UW,V,W,Y,Z,ZH
Novel of size 4: +voice,-labiodental,-lateral,-syllabic	B,D,DH,G,JH,M,N,NG,R,W,Y,Z,ZH
Novel of size 2: -round,-syllabic	B,CH,D,DH,F,G,HH,JH,K,L,M,N,NG,P,R,S,SH,T,TH,V,Y,Z,ZH
Novel of size 4: +consonantal,-nasal,+voice,+anterior	D,DH,L,Z
Novel of size 3: -approximant,+voice,+anterior	D,DH,N,Z
Novel of size 3: +consonantal,+continuant,-labial	DH,L,S,SH,TH,Z,ZH
Novel of size 4: +continuant,+voice,-labial,-lateral	AA,AE,AH,DH,EH,ER,EY,IH,IY,R,Y,Z,ZH
Novel of size 5: -nasal,+voice,+anterior,-strident,-lateral	D,DH,ER
Novel of size 3: -labial,-high,-tense	AH,EH,ER
Novel of size 2: -lateral,-syllabic	B,CH,D,DH,F,G,HH,JH,K,M,N,NG,P,R,S,SH,T,TH,V,W,Y,Z,ZH
Novel of size 2: +continuant,+distributed	DH,ER,R,SH,TH,ZH
Novel of size 4: +continuant,+coronal,-lateral,-dorsal	DH,R,S,SH,TH,Z,ZH
Novel of size 2: +consonantal,+labial	B,F,M,P,V
Novel of size 2: -high,+front	AE,EH,EY
Novel of size 4: +continuant,+voice,+anterior,-strident	DH,ER,L
Novel of size 6: -nasal,-spread_glottis,-round,-labiodental,-coronal,-syllabic	B,G,K,P,Y
Novel of size 4: -labial,-coronal,-high,-low	AH,EH,EY
Novel of size 4: -sonorant,-continuant,+voice,+coronal	D,JH
Novel of size 3: +voice,+distributed,-strident	DH,ER,R
Novel of size 3: -nasal,+labial,-syllabic	B,F,P,V,W
Novel of size 3: -labial,+high,+tense	IY,Y
Novel of size 4: +continuant,+voice,+anterior,-lateral	DH,ER,Z
Novel of size 4: -nasal,+voice,-coronal,-syllabic	B,G,V,W,Y
Novel of size 2: -nasal,-distributed	D,L,S,T,Z
Novel of size 3: -sonorant,-labial,-coronal	G,HH,K
Novel of size 4: -sonorant,-labiodental,-coronal,-dorsal	B,HH,P
Novel of size 4: -nasal,-spread_glottis,-labiodental,-lateral	AA,AE,AH,AO,B,CH,D,DH,EH,ER,EY,G,IH,IY,JH,K,OW,P,R,S,SH,T,TH,UH,UW,W,Y,Z,ZH
Novel of size 2: -approximant,-distributed	D,N,S,T,Z
Novel of size 3: -voice,-coronal,-dorsal	F,HH,P
Novel of size 2: +sonorant,+coronal	ER,L,N,R
Novel of size 3: -voice,-labiodental,-coronal	HH,K,P
Novel of size 2: +delayed_release,-coronal	F,HH,V
Novel of size 2: -continuant,+delayed_release	CH,JH
Novel of size 2: -high,-tense	AH,AO,EH,ER
Novel of size 3: -nasal,-spread_glottis,-labial	AA,AE,AH,CH,D,DH,EH,ER,EY,G,IH,IY,JH,K,L,R,S,SH,T,TH,Y,Z,ZH
Novel of size 3: -consonantal,-labial,-syllabic	HH,R,Y
Novel of size 3: -consonantal,-coronal,-syllabic	HH,W,Y
Novel of size 3: +voice,-strident,-dorsal	D,DH,L,N,R
Novel of size 3: +voice,-round,-syllabic	B,D,DH,G,JH,L,M,N,NG,R,V,Y,Z,ZH
Novel of size 2: +continuant,+voice	AA,AE,AH,AO,DH,EH,ER,EY,IH,IY,L,OW,R,UH,UW,V,W,Y,Z,ZH
Novel of size 2: +nasal,+dorsal	NG
Novel of size 3: +voice,-labiodental,-syllabic	B,D,DH,G,JH,L,M,N,NG,R,W,Y,Z,ZH
Novel of size 1: -delayed_release	B,D,G,K,P,T
Novel of size 3: +consonantal,+voice,+anterior	D,DH,L,N,Z
Novel of size 3: +consonantal,-sonorant,-coronal	B,F,G,K,P,V
Novel of size 3: +continuant,+voice,-labial	AA,AE,AH,DH,EH,ER,EY,IH,IY,L,R,Y,Z,ZH
Novel of size 4: -nasal,+voice,+anterior,-strident	D,DH,ER,L
Novel of size 2: +front,-tense	EH,IH
Novel of size 3: -labial,-coronal,-high	AA,AE,AH,EH,EY
Novel of size 3: +voice,-lateral,-syllabic	B,D,DH,G,JH,M,N,NG,R,V,W,Y,Z,ZH
Novel of size 4: +voice,+anterior,-strident,-lateral	D,DH,ER,N
Novel of size 3: +consonantal,-sonorant,+continuant	DH,F,S,SH,TH,V,Z,ZH
Novel of size 4: -sonorant,-continuant,+voice,-dorsal	B,D,JH
Novel of size 1: -syllabic	B,CH,D,DH,F,G,HH,JH,K,L,M,N,NG,P,R,S,SH,T,TH,V,W,Y,Z,ZH
Novel of size 3: +continuant,+coronal,-dorsal	DH,L,R,S,SH,TH,Z,ZH
Novel of size 4: -nasal,+voice,-strident,-lateral	D,DH,ER,R
Novel of size 4: -sonorant,-continuant,+voice,-labial	D,G,JH
Novel of size 4: +continuant,+voice,-round,-lateral	AA,AE,AH,DH,EH,ER,EY,IH,IY,R,V,Y,Z,ZH
Novel of size 3: +continuant,+voice,-strident	DH,ER,L,R
Novel of size 4: -nasal,+voice,+anterior,-lateral	D,DH,ER,Z
Novel of size 3: -continuant,+voice,+coronal	D,JH,N
Novel of size 2: +labial,-syllabic	B,F,M,P,V,W
Novel of size 5: +continuant,-spread_glottis,-labial,-lateral,-syllabic	DH,R,S,SH,TH,Y,Z,ZH
Novel of size 5: -nasal,-spread_glottis,-labiodental,-coronal,-syllabic	B,G,K,P,W,Y
Novel of size 3: +continuant,+voice,+anterior	DH,ER,L,Z
Novel of size 3: -nasal,-spread_glottis,-labiodental	AA,AE,AH,AO,B,CH,D,DH,EH,ER,EY,G,IH,IY,JH,K,L,OW,P,R,S,SH,T,TH,UH,UW,W,Y,Z,ZH
Novel of size 1: -distributed	D,L,N,S,T,Z
Novel of size 3: -labiodental,-coronal,-dorsal	B,HH,M,P
Novel of size 2: -voice,-coronal	F,HH,K,P
Novel of size 3: -labial,+tense,+syllabic	EY,IY
Novel of size 3: +labial,-high,+tense	OW
Novel of size 3: -labial,-coronal,-tense	AH,EH,IH
Novel of size 4: -nasal,-labial,-coronal,-syllabic	G,HH,K,Y
Novel of size 2: +sonorant,+high	IH,IY,NG,UH,UW,W,Y
Novel of size 5: -nasal,-spread_glottis,-round,-labiodental,-lateral	AA,AE,AH,B,CH,D,DH,EH,ER,EY,G,IH,IY,JH,K,P,R,S,SH,T,TH,Y,Z,ZH
Novel of size 4: +continuant,-round,-coronal,-syllabic	F,HH,V,Y
Novel of size 3: +consonantal,+voice,+dorsal	G,NG
Novel of size 2: -consonantal,-syllabic	HH,R,W,Y
Novel of size 3: -high,-low,-back	EH,ER,EY
Novel of size 2: +nasal,-coronal	M,NG
Novel of size 2: +nasal,-labial	N,NG
Novel of size 3: -sonorant,-continuant,+voice	B,D,G,JH
Novel of size 2: +voice,-syllabic	B,D,DH,G,JH,L,M,N,NG,R,V,W,Y,Z,ZH
Novel of size 3: +voice,+anterior,-strident	D,DH,ER,L,N
Novel of size 2: +consonantal,+continuant	DH,F,L,S,SH,TH,V,Z,ZH
Novel of size 4: +sonorant,-labial,-coronal,-syllabic	NG,Y
Novel of size 3: -nasal,+voice,-strident	D,DH,ER,L,R
Novel of size 3: +voice,-strident,-lateral	D,DH,ER,N,R
Novel of size 2: +labial,-high	AO,OW
Novel of size 4: +continuant,-spread_glottis,-lateral,-dorsal	DH,F,R,S,SH,TH,V,Z,ZH
Novel of size 3: +continuant,+voice,-round	AA,AE,AH,DH,EH,ER,EY,IH,IY,L,R,V,Y,Z,ZH
Novel of size 5: -nasal,-spread_glottis,-round,-coronal,-syllabic	B,F,G,K,P,V,Y
Novel of size 3: -nasal,+voice,+anterior	D,DH,ER,L,Z
Novel of size 3: +voice,+anterior,-lateral	D,DH,ER,N,Z
Novel of size 2: +consonantal,+distributed	CH,DH,JH,SH,TH,ZH
Novel of size 4: +continuant,-spread_glottis,-labial,-syllabic	DH,L,R,S,SH,TH,Y,Z,ZH
Novel of size 3: -sonorant,-labiodental,-coronal	B,G,HH,K,P
Novel of size 3: +continuant,+coronal,-lateral	DH,ER,R,S,SH,TH,Z,ZH
Novel of size 2: -high,-back	AE,EH,ER,EY
Novel of size 3: -sonorant,+continuant,-labial	DH,HH,S,SH,TH,Z,ZH
Novel of size 5: +continuant,-spread_glottis,-labiodental,-lateral,-syllabic	DH,R,S,SH,TH,W,Y,Z,ZH
Novel of size 3: -labial,-high,-low	AH,EH,ER,EY
Novel of size 3: -sonorant,-coronal,-dorsal	B,F,HH,P,V
Novel of size 3: -nasal,-spread_glottis,-lateral	AA,AE,AH,AO,B,CH,D,DH,EH,ER,EY,F,G,IH,IY,JH,K,OW,P,R,S,SH,T,TH,UH,UW,V,W,Y,Z,ZH
Novel of size 2: +voice,+high	G,IH,IY,NG,UH,UW,W,Y
Novel of size 3: -sonorant,-continuant,+coronal	CH,D,JH,T
Novel of size 4: -nasal,-spread_glottis,-round,-labiodental	AA,AE,AH,B,CH,D,DH,EH,ER,EY,G,IH,IY,JH,K,L,P,R,S,SH,T,TH,Y,Z,ZH
Novel of size 2: -labial,+tense	EY,IY,Y
Novel of size 3: -high,-low,+back	AH,AO,OW
Novel of size 2: +consonantal,+dorsal	G,K,NG
Novel of size 3: +continuant,-coronal,-syllabic	F,HH,V,W,Y
Novel of size 3: -labial,+high,+syllabic	IH,IY
Novel of size 3: +consonantal,+sonorant,-labial	L,N,NG
Novel of size 1: +nasal	M,N,NG
Novel of size 3: +continuant,-voice,-anterior	SH
Novel of size 4: +voice,-labial,-coronal,-syllabic	G,NG,Y
Novel of size 2: -high,+back	AA,AH,AO,OW
Novel of size 3: -nasal,-labial,-lateral	AA,AE,AH,CH,D,DH,EH,ER,EY,G,HH,IH,IY,JH,K,R,S,SH,T,TH,Y,Z,ZH
Novel of size 3: -continuant,+voice,-dorsal	B,D,JH,M,N
Novel of size 4: +sonorant,-round,-coronal,-syllabic	M,NG,Y
Novel of size 2: +voice,-strident	D,DH,ER,L,N,R
Novel of size 3: +continuant,-spread_glottis,-dorsal	DH,F,L,R,S,SH,TH,V,Z,ZH
Novel of size 2: +voice,+anterior	D,DH,ER,L,N,Z
Novel of size 3: +sonorant,+dorsal,-syllabic	NG,W,Y
Novel of size 2: -labial,-high	AA,AE,AH,EH,ER,EY
Novel of size 2: -back,-tense	EH,ER,IH
Novel of size 5: +continuant,-spread_glottis,-round,-lateral,-syllabic	DH,F,R,S,SH,TH,V,Y,Z,ZH
Novel of size 2: +distributed,-dorsal	CH,DH,JH,R,SH,TH,ZH
Novel of size 4: -nasal,-spread_glottis,-coronal,-syllabic	B,F,G,K,P,V,W,Y
Novel of size 2: +continuant,+coronal	DH,ER,L,R,S,SH,TH,Z,ZH
Novel of size 3: +continuant,-voice,-strident	TH
Novel of size 4: +continuant,-spread_glottis,-labiodental,-syllabic	DH,L,R,S,SH,TH,W,Y,Z,ZH
Novel of size 2: -nasal,-spread_glottis	AA,AE,AH,AO,B,CH,D,DH,EH,ER,EY,F,G,IH,IY,JH,K,L,OW,P,R,S,SH,T,TH,UH,UW,V,W,Y,Z,ZH
Novel of size 4: +continuant,-labial,-lateral,-dorsal	DH,HH,R,S,SH,TH,Z,ZH
Novel of size 2: -coronal,-dorsal	B,F,HH,M,P,V
Novel of size 5: -nasal,-round,-labiodental,-coronal,-syllabic	B,G,HH,K,P,Y
Novel of size 1: +high	G,IH,IY,K,NG,UH,UW,W,Y
Novel of size 2: -continuant,+coronal	CH,D,JH,N,T
Novel of size 4: -nasal,-spread_glottis,-round,-lateral	AA,AE,AH,B,CH,D,DH,EH,ER,EY,F,G,IH,IY,JH,K,P,R,S,SH,T,TH,V,Y,Z,ZH
Novel of size 3: -continuant,+voice,-coronal	B,G,M,NG
Novel of size 3: -nasal,-labiodental,-lateral	AA,AE,AH,AO,B,CH,D,DH,EH,ER,EY,G,HH,IH,IY,JH,K,OW,P,R,S,SH,T,TH,UH,UW,W,Y,Z,ZH
Novel of size 3: +labial,+high,-tense	UH
Novel of size 2: -labial,-tense	AH,EH,ER,IH
Novel of size 2: -high,+tense	EY,OW
Novel of size 2: +consonantal,+sonorant	L,M,N,NG
Novel of size 4: +labial,+high,+tense,+syllabic	UW
Novel of size 3: -labial,+dorsal,-syllabic	G,K,NG,Y
Novel of size 2: +high,+front	IH,IY,Y
Novel of size 3: +continuant,-voice,+strident	S,SH
Novel of size 2: -nasal,-labial	AA,AE,AH,CH,D,DH,EH,ER,EY,G,HH,IH,IY,JH,K,L,R,S,SH,T,TH,Y,Z,ZH
Novel of size 3: +voice,+dorsal,-syllabic	G,NG,W,Y
Novel of size 4: +sonorant,-labial,-lateral,-syllabic	N,NG,R,Y
Novel of size 3: +sonorant,-coronal,-syllabic	M,NG,W,Y
Novel of size 2: -voice,-anterior	CH,SH
Novel of size 4: +continuant,-spread_glottis,-round,-syllabic	DH,F,L,R,S,SH,TH,V,Y,Z,ZH
Novel of size 2: -sonorant,-coronal	B,F,G,HH,K,P,V
Novel of size 2: +labial,-tense	AO,UH
Novel of size 2: -sonorant,+continuant	DH,F,HH,S,SH,TH,V,Z,ZH
Novel of size 3: +continuant,-labial,-dorsal	DH,HH,L,R,S,SH,TH,Z,ZH
Novel of size 4: +continuant,-spread_glottis,-lateral,-syllabic	DH,F,R,S,SH,TH,V,W,Y,Z,ZH
Novel of size 3: +continuant,-voice,+anterior	S,TH
Novel of size 2: -voice,-strident	T,TH
Novel of size 2: +delayed_release,+coronal	CH,DH,JH,S,SH,TH,Z,ZH
Novel of size 3: -sonorant,-continuant,-labial	CH,D,G,JH,K,T
Novel of size 3: -sonorant,-continuant,-dorsal	B,CH,D,JH,P,T
Novel of size 4: +continuant,-labial,-lateral,-syllabic	DH,HH,R,S,SH,TH,Y,Z,ZH
Novel of size 4: -nasal,-labiodental,-coronal,-syllabic	B,G,HH,K,P,W,Y
Novel of size 3: -nasal,-spread_glottis,-round	AA,AE,AH,B,CH,D,DH,EH,ER,EY,F,G,IH,IY,JH,K,L,P,R,S,SH,T,TH,V,Y,Z,ZH
Novel of size 2: -nasal,-labiodental	AA,AE,AH,AO,B,CH,D,DH,EH,ER,EY,G,HH,IH,IY,JH,K,L,OW,P,R,S,SH,T,TH,UH,UW,W,Y,Z,ZH
Novel of size 3: +consonantal,+voice,-coronal	B,G,M,NG,V
Novel of size 2: +back,-tense	AH,AO,UH
Novel of size 5: +voice,-round,-labiodental,-coronal,-syllabic	B,G,M,NG,Y
Novel of size 3: -high,-low,-front	AH,AO,ER,OW
Novel of size 4: -nasal,+voice,-labial,+high	G,IH,IY,Y
Novel of size 4: -nasal,-round,-labiodental,-lateral	AA,AE,AH,B,CH,D,DH,EH,ER,EY,G,HH,IH,IY,JH,K,P,R,S,SH,T,TH,Y,Z,ZH
Novel of size 2: +delayed_release,-strident	DH,TH
Novel of size 3: +labial,+high,+tense	UW,W
Novel of size 2: +dorsal,-syllabic	G,K,NG,W,Y
Novel of size 3: +sonorant,-labial,-syllabic	L,N,NG,R,Y
Novel of size 4: +sonorant,-round,-lateral,-syllabic	M,N,NG,R,Y
Novel of size 2: -high,-front	AA,AH,AO,ER,OW
Novel of size 2: -voice,+strident	CH,S,SH
Novel of size 3: +continuant,-spread_glottis,-syllabic	DH,F,L,R,S,SH,TH,V,W,Y,Z,ZH
Novel of size 3: +continuant,-lateral,-dorsal	DH,F,HH,R,S,SH,TH,V,Z,ZH
Novel of size 3: -coronal,-low,+syllabic	AH,AO,EH,EY,IH,IY,OW,UH,UW
Novel of size 4: -nasal,-round,-coronal,-syllabic	B,F,G,HH,K,P,V,Y
Novel of size 2: -voice,+anterior	S,T,TH
Novel of size 1: +distributed	CH,DH,ER,JH,R,SH,TH,ZH
Novel of size 3: +continuant,-labial,-syllabic	DH,HH,L,R,S,SH,TH,Y,Z,ZH
Novel of size 4: -nasal,+voice,-labiodental,-lateral	AA,AE,AH,AO,B,D,DH,EH,ER,EY,G,IH,IY,JH,OW,R,UH,UW,W,Y,Z,ZH
Novel of size 2: -continuant,-coronal	B,G,K,M,NG,P
Novel of size 4: +continuant,-labiodental,-lateral,-syllabic	DH,HH,R,S,SH,TH,W,Y,Z,ZH
Novel of size 2: -nasal,-lateral	AA,AE,AH,AO,B,CH,D,DH,EH,ER,EY,F,G,HH,IH,IY,JH,K,OW,P,R,S,SH,T,TH,UH,UW,V,W,Y,Z,ZH
Novel of size 4: +consonantal,+continuant,+voice,-anterior	ZH
Novel of size 3: -nasal,-labial,+high	G,IH,IY,K,Y
Novel of size 3: -nasal,-round,-labiodental	AA,AE,AH,B,CH,D,DH,EH,ER,EY,G,HH,IH,IY,JH,K,L,P,R,S,SH,T,TH,Y,Z,ZH
Novel of size 4: -nasal,+voice,-labial,-lateral	AA,AE,AH,D,DH,EH,ER,EY,G,IH,IY,JH,R,Y,Z,ZH
Novel of size 4: +voice,-round,-coronal,-syllabic	B,G,M,NG,V,Y
Novel of size 4: +voice,-labiodental,-coronal,-syllabic	B,G,M,NG,W,Y
Novel of size 3: +consonantal,+continuant,-strident	DH,L,TH
Novel of size 3: +distributed,-strident,-dorsal	DH,R,TH
Novel of size 3: +sonorant,-round,-syllabic	L,M,N,NG,R,Y
Novel of size 3: -approximant,-labial,-coronal	G,HH,K,NG
Novel of size 3: +sonorant,-lateral,-syllabic	M,N,NG,R,W,Y
Novel of size 2: -coronal,+syllabic	AA,AE,AH,AO,EH,EY,IH,IY,OW,UH,UW
Novel of size 2: -sonorant,-continuant	B,CH,D,G,JH,K,P,T
Novel of size 2: +continuant,-dorsal	DH,F,HH,L,R,S,SH,TH,V,Z,ZH
Novel of size 2: -sonorant,+coronal	CH,D,DH,JH,S,SH,T,TH,Z,ZH
Novel of size 3: -spread_glottis,-labial,-lateral	AA,AE,AH,CH,D,DH,EH,ER,EY,G,IH,IY,JH,K,N,NG,R,S,SH,T,TH,Y,Z,ZH
Novel of size 2: +consonantal,+delayed_release	CH,DH,F,JH,S,SH,TH,V,Z,ZH
Novel of size 2: -continuant,-dorsal	B,CH,D,JH,M,N,P,T
Novel of size 3: -nasal,+voice,-labiodental	AA,AE,AH,AO,B,D,DH,EH,ER,EY,G,IH,IY,JH,L,OW,R,UH,UW,W,Y,Z,ZH
Novel of size 4: +continuant,-round,-lateral,-syllabic	DH,F,HH,R,S,SH,TH,V,Y,Z,ZH
Novel of size 3: -nasal,-coronal,-syllabic	B,F,G,HH,K,P,V,W,Y
Novel of size 3: +continuant,-labiodental,-syllabic	DH,HH,L,R,S,SH,TH,W,Y,Z,ZH
Novel of size 3: -nasal,+voice,-lateral	AA,AE,AH,AO,B,D,DH,EH,ER,EY,G,IH,IY,JH,OW,R,UH,UW,V,W,Y,Z,ZH
Novel of size 1: -nasal	AA,AE,AH,AO,B,CH,D,DH,EH,ER,EY,F,G,HH,IH,IY,JH,K,L,OW,P,R,S,SH,T,TH,UH,UW,V,W,Y,Z,ZH
Novel of size 3: +continuant,+voice,-anterior	R,ZH
Novel of size 5: -nasal,+voice,-round,-labiodental,-lateral	AA,AE,AH,B,D,DH,EH,ER,EY,G,IH,IY,JH,R,Y,Z,ZH
Novel of size 5: -spread_glottis,-round,-labiodental,-coronal,-syllabic	B,G,K,M,NG,P,Y
Novel of size 3: +continuant,+voice,+strident	Z,ZH
Novel of size 3: -nasal,+voice,-labial	AA,AE,AH,D,DH,EH,ER,EY,G,IH,IY,JH,L,R,Y,Z,ZH
Novel of size 3: -nasal,-round,-lateral	AA,AE,AH,B,CH,D,DH,EH,ER,EY,F,G,HH,IH,IY,JH,K,P,R,S,SH,T,TH,V,Y,Z,ZH
Novel of size 2: -sonorant,-strident	D,DH,T,TH
Novel of size 3: -coronal,-high,-low	AH,AO,EH,EY,OW
Novel of size 2: -front,-tense	AH,AO,ER,UH
Novel of size 3: +voice,-coronal,-syllabic	B,G,M,NG,V,W,Y
Novel of size 3: +continuant,-strident,-dorsal	DH,L,R,TH
Novel of size 2: +sonorant,-syllabic	L,M,N,NG,R,W,Y
Novel of size 3: -labial,-coronal,-syllabic	G,HH,K,NG,Y
Novel of size 2: +delayed_release,+anterior	DH,S,TH,Z
Novel of size 2: +anterior,+distributed	DH,ER,TH
Novel of size 3: -low,+front,+syllabic	EH,EY,IH,IY
Novel of size 3: +consonantal,-nasal,+coronal	CH,D,DH,JH,L,S,SH,T,TH,Z,ZH
Novel of size 2: -approximant,+coronal	CH,D,DH,JH,N,S,SH,T,TH,Z,ZH
Novel of size 2: -spread_glottis,-labial	AA,AE,AH,CH,D,DH,EH,ER,EY,G,IH,IY,JH,K,L,N,NG,R,S,SH,T,TH,Y,Z,ZH
Novel of size 2: +high,-tense	IH,UH
Novel of size 4: +consonantal,+continuant,+voice,+distributed	DH,ZH
Novel of size 4: -nasal,+coronal,-lateral,-dorsal	CH,D,DH,JH,R,S,SH,T,TH,Z,ZH
Novel of size 3: +continuant,-round,-syllabic	DH,F,HH,L,R,S,SH,TH,V,Y,Z,ZH
Novel of size 2: -nasal,+voice	AA,AE,AH,AO,B,D,DH,EH,ER,EY,G,IH,IY,JH,L,OW,R,UH,UW,V,W,Y,Z,ZH
Novel of size 2: -low,+syllabic	AH,AO,EH,ER,EY,IH,IY,OW,UH,UW
Novel of size 2: +consonantal,-coronal	B,F,G,K,M,NG,P,V
Novel of size 3: +continuant,-lateral,-syllabic	DH,F,HH,R,S,SH,TH,V,W,Y,Z,ZH
Novel of size 3: -consonantal,-coronal,-low	AH,AO,EH,EY,IH,IY,OW,UH,UW,W,Y
Novel of size 2: +front,+syllabic	AE,EH,EY,IH,IY
Novel of size 2: +delayed_release,-labial	CH,DH,HH,JH,S,SH,TH,Z,ZH
Novel of size 4: -nasal,+voice,-round,-labiodental	AA,AE,AH,B,D,DH,EH,ER,EY,G,IH,IY,JH,L,R,Y,Z,ZH
Novel of size 4: -labial,-coronal,-low,+syllabic	AH,EH,EY,IH,IY
Novel of size 3: -continuant,+voice,-labial	D,G,JH,N,NG
Novel of size 3: +high,+tense,+syllabic	IY,UW
Novel of size 4: -nasal,+voice,-round,-lateral	AA,AE,AH,B,D,DH,EH,ER,EY,G,IH,IY,JH,R,V,Y,Z,ZH
Novel of size 2: -nasal,-round	AA,AE,AH,B,CH,D,DH,EH,ER,EY,F,G,HH,IH,IY,JH,K,L,P,R,S,SH,T,TH,V,Y,Z,ZH
Novel of size 2: -coronal,-high	AA,AE,AH,AO,EH,EY,OW
Novel of size 4: -spread_glottis,-labiodental,-coronal,-syllabic	B,G,K,M,NG,P,W,Y
Novel of size 3: +consonantal,-nasal,-strident	D,DH,L,T,TH
Novel of size 2: -approximant,-strident	D,DH,N,T,TH
Novel of size 4: -nasal,-strident,-lateral,-dorsal	D,DH,R,T,TH
Novel of size 3: -spread_glottis,-labiodental,-lateral	AA,AE,AH,AO,B,CH,D,DH,EH,ER,EY,G,IH,IY,JH,K,M,N,NG,OW,P,R,S,SH,T,TH,UH,UW,W,Y,Z,ZH
Novel of size 3: +consonantal,+continuant,+anterior	DH,L,S,TH,Z
Novel of size 3: +continuant,+anterior,-strident	DH,ER,L,TH
Novel of size 3: +consonantal,-sonorant,-labial	CH,D,DH,G,JH,K,S,SH,T,TH,Z,ZH
Novel of size 4: +consonantal,-sonorant,-labiodental,-dorsal	B,CH,D,DH,JH,P,S,SH,T,TH,Z,ZH
Novel of size 2: +distributed,-strident	DH,ER,R,TH
Novel of size 2: +consonantal,+coronal	CH,D,DH,JH,L,N,S,SH,T,TH,Z,ZH
Novel of size 2: -low,+front	EH,EY,IH,IY,Y
Novel of size 3: -nasal,+coronal,-dorsal	CH,D,DH,JH,L,R,S,SH,T,TH,Z,ZH
Novel of size 3: +coronal,-lateral,-dorsal	CH,D,DH,JH,N,R,S,SH,T,TH,Z,ZH
Novel of size 4: +continuant,+voice,+distributed,-dorsal	DH,R,ZH
Novel of size 1: +syllabic	AA,AE,AH,AO,EH,ER,EY,IH,IY,OW,UH,UW
Novel of size 2: +approximant,-coronal	AA,AE,AH,AO,EH,EY,IH,IY,OW,UH,UW,W,Y
Novel of size 4: -sonorant,+continuant,+voice,-labial	DH,Z,ZH
Novel of size 4: -nasal,+voice,-coronal,-low	AH,AO,EH,EY,G,IH,IY,OW,UH,UW,W,Y
Novel of size 3: -labial,-coronal,+syllabic	AA,AE,AH,EH,EY,IH,IY
Novel of size 2: +continuant,-syllabic	DH,F,HH,L,R,S,SH,TH,V,W,Y,Z,ZH
Novel of size 4: -spread_glottis,-round,-coronal,-syllabic	B,F,G,K,M,NG,P,V,Y
Novel of size 3: -nasal,+voice,-round	AA,AE,AH,B,D,DH,EH,ER,EY,G,IH,IY,JH,L,R,V,Y,Z,ZH
Novel of size 1: +front	AE,EH,EY,IH,IY,Y
Novel of size 4: -consonantal,-labial,-coronal,-low	AH,EH,EY,IH,IY,Y
Novel of size 2: +consonantal,-strident	D,DH,L,N,T,TH
Novel of size 3: -approximant,-labiodental,-coronal	B,G,HH,K,M,NG,P
Novel of size 3: -nasal,-strident,-dorsal	D,DH,L,R,T,TH
Novel of size 3: -strident,-lateral,-dorsal	D,DH,N,R,T,TH
Novel of size 2: -spread_glottis,-labiodental	AA,AE,AH,AO,B,CH,D,DH,EH,ER,EY,G,IH,IY,JH,K,L,M,N,NG,OW,P,R,S,SH,T,TH,UH,UW,W,Y,Z,ZH
Novel of size 2: -sonorant,+anterior	D,DH,S,T,TH,Z
Novel of size 4: -nasal,+anterior,-strident,-lateral	D,DH,ER,T,TH
Novel of size 2: -high,-low	AH,AO,EH,ER,EY,OW
Novel of size 3: +consonantal,-nasal,-labial	CH,D,DH,G,JH,K,L,S,SH,T,TH,Z,ZH
Novel of size 4: +consonantal,-nasal,-labiodental,-dorsal	B,CH,D,DH,JH,L,P,S,SH,T,TH,Z,ZH
Novel of size 2: +continuant,-strident	DH,ER,L,R,TH
Novel of size 4: -spread_glottis,-round,-labiodental,-lateral	AA,AE,AH,B,CH,D,DH,EH,ER,EY,G,IH,IY,JH,K,M,N,NG,P,R,S,SH,T,TH,Y,Z,ZH
Novel of size 5: -nasal,-spread_glottis,-labiodental,-lateral,-dorsal	B,CH,D,DH,JH,P,R,S,SH,T,TH,Z,ZH
Novel of size 2: +coronal,-dorsal	CH,D,DH,JH,L,N,R,S,SH,T,TH,Z,ZH
Novel of size 3: +continuant,+anterior,-lateral	DH,ER,S,TH,Z
Novel of size 3: -low,-back,+syllabic	EH,ER,EY,IH,IY
Novel of size 4: -nasal,+voice,-coronal,+dorsal	AA,AE,AH,AO,EH,EY,G,IH,IY,OW,UH,UW,W,Y
Novel of size 4: +consonantal,+continuant,+voice,-labial	DH,L,Z,ZH
Novel of size 3: -nasal,-coronal,-low	AH,AO,EH,EY,G,IH,IY,K,OW,UH,UW,W,Y
Novel of size 5: +continuant,+voice,-labial,-lateral,-dorsal	DH,R,Z,ZH
Novel of size 2: -continuant,+voice	B,D,G,JH,M,N,NG
Novel of size 3: +sonorant,-labial,+high	IH,IY,NG,Y
Novel of size 3: -sonorant,+continuant,+voice	DH,V,Z,ZH
Novel of size 3: +continuant,+voice,-coronal	AA,AE,AH,AO,EH,EY,IH,IY,OW,UH,UW,V,W,Y
Novel of size 3: -nasal,+coronal,-lateral	CH,D,DH,ER,JH,R,S,SH,T,TH,Z,ZH
Novel of size 3: -sonorant,-labial,-dorsal	CH,D,DH,HH,JH,S,SH,T,TH,Z,ZH
Novel of size 2: -labial,-lateral	AA,AE,AH,CH,D,DH,EH,ER,EY,G,HH,IH,IY,JH,K,N,NG,R,S,SH,T,TH,Y,Z,ZH
Novel of size 1: +delayed_release	CH,DH,F,HH,JH,S,SH,TH,V,Z,ZH
Novel of size 3: +approximant,-labial,-coronal	AA,AE,AH,EH,EY,IH,IY,Y
Novel of size 3: +consonantal,+voice,-anterior	JH,ZH
Novel of size 5: -nasal,+voice,-labial,-coronal,-low	AH,EH,EY,G,IH,IY,Y
Novel of size 2: -consonantal,-low	AH,AO,EH,ER,EY,IH,IY,OW,UH,UW,W,Y
Novel of size 3: -spread_glottis,-coronal,-syllabic	B,F,G,K,M,NG,P,V,W,Y
Novel of size 2: -back,+syllabic	AE,EH,ER,EY,IH,IY
Novel of size 3: -labial,-low,+syllabic	AH,EH,ER,EY,IH,IY
Novel of size 2: -strident,-dorsal	D,DH,L,N,R,T,TH
Novel of size 2: -spread_glottis,-lateral	AA,AE,AH,AO,B,CH,D,DH,EH,ER,EY,F,G,IH,IY,JH,K,M,N,NG,OW,P,R,S,SH,T,TH,UH,UW,V,W,Y,Z,ZH
Novel of size 2: +high,+tense	IY,UW,W,Y
Novel of size 4: -round,-labiodental,-coronal,-syllabic	B,G,HH,K,M,NG,P,Y
Novel of size 1: -high	AA,AE,AH,AO,EH,ER,EY,OW
Novel of size 3: +consonantal,-sonorant,-labiodental	B,CH,D,DH,G,JH,K,P,S,SH,T,TH,Z,ZH
Novel of size 3: +consonantal,-nasal,+anterior	D,DH,L,S,T,TH,Z
Novel of size 3: -nasal,+anterior,-strident	D,DH,ER,L,T,TH
Novel of size 3: +labial,+tense,+syllabic	OW,UW
Novel of size 2: -approximant,+anterior	D,DH,N,S,T,TH,Z
Novel of size 3: +anterior,-strident,-lateral	D,DH,ER,N,T,TH
Novel of size 3: -nasal,-strident,-lateral	D,DH,ER,R,T,TH
Novel of size 3: -spread_glottis,-round,-labiodental	AA,AE,AH,B,CH,D,DH,EH,ER,EY,G,IH,IY,JH,K,L,M,N,NG,P,R,S,SH,T,TH,Y,Z,ZH
Novel of size 4: +consonantal,-approximant,-labiodental,-dorsal	B,CH,D,DH,JH,M,N,P,S,SH,T,TH,Z,ZH
Novel of size 3: +consonantal,-sonorant,-dorsal	B,CH,D,DH,F,JH,P,S,SH,T,TH,V,Z,ZH
Novel of size 4: -nasal,-spread_glottis,-labiodental,-dorsal	B,CH,D,DH,JH,L,P,R,S,SH,T,TH,Z,ZH
Novel of size 4: -nasal,+voice,-labiodental,-coronal	AA,AE,AH,AO,B,EH,EY,G,IH,IY,OW,UH,UW,W,Y
Novel of size 2: +continuant,+anterior	DH,ER,L,S,TH,Z
Novel of size 3: -nasal,-coronal,+dorsal	AA,AE,AH,AO,EH,EY,G,IH,IY,K,OW,UH,UW,W,Y
Novel of size 5: -nasal,-spread_glottis,-labial,-lateral,-syllabic	CH,D,DH,G,JH,K,R,S,SH,T,TH,Y,Z,ZH
Novel of size 3: +continuant,-spread_glottis,-coronal	AA,AE,AH,AO,EH,EY,F,IH,IY,OW,UH,UW,V,W,Y
Novel of size 3: +voice,-labial,+high	G,IH,IY,NG,Y
Novel of size 2: -coronal,-tense	AH,AO,EH,IH,UH
Novel of size 4: +continuant,+voice,-labial,-dorsal	DH,L,R,Z,ZH
Novel of size 2: -low,-back	EH,ER,EY,IH,IY,Y
Novel of size 2: -nasal,+coronal	CH,D,DH,ER,JH,L,R,S,SH,T,TH,Z,ZH
Novel of size 3: +consonantal,+continuant,+voice	DH,L,V,Z,ZH
Novel of size 2: +coronal,-lateral	CH,D,DH,ER,JH,N,R,S,SH,T,TH,Z,ZH
Novel of size 1: -labial	AA,AE,AH,CH,D,DH,EH,ER,EY,G,HH,IH,IY,JH,K,L,N,NG,R,S,SH,T,TH,Y,Z,ZH
Novel of size 3: +continuant,+voice,+distributed	DH,ER,R,ZH
Novel of size 3: -approximant,-labial,-dorsal	CH,D,DH,HH,JH,N,S,SH,T,TH,Z,ZH
Novel of size 4: -nasal,+voice,-labial,-coronal	AA,AE,AH,EH,EY,G,IH,IY,Y
Novel of size 4: +continuant,+voice,-lateral,-dorsal	DH,R,V,Z,ZH
Novel of size 4: -nasal,-labial,-lateral,-dorsal	CH,D,DH,HH,JH,R,S,SH,T,TH,Z,ZH
Novel of size 5: +continuant,+voice,-labial,-lateral,-syllabic	DH,R,Y,Z,ZH
Novel of size 4: -nasal,-labial,-coronal,-low	AH,EH,EY,G,IH,IY,K,Y
Novel of size 2: -consonantal,+dorsal	AA,AE,AH,AO,EH,ER,EY,IH,IY,OW,UH,UW,W,Y
Novel of size 3: -nasal,+voice,-low	AH,AO,EH,ER,EY,G,IH,IY,OW,UH,UW,W,Y
Novel of size 2: +voice,-anterior	JH,R,ZH
Novel of size 2: -labial,+syllabic	AA,AE,AH,EH,ER,EY,IH,IY
Novel of size 4: +continuant,+voice,-round,-coronal	AA,AE,AH,EH,EY,IH,IY,V,Y
Novel of size 2: -approximant,-coronal	B,F,G,HH,K,M,NG,P,V
Novel of size 2: +voice,+strident	JH,Z,ZH
Novel of size 3: +continuant,-voice,+distributed	SH,TH
Novel of size 1: -spread_glottis	AA,AE,AH,AO,B,CH,D,DH,EH,ER,EY,F,G,IH,IY,JH,K,L,M,N,NG,OW,P,R,S,SH,T,TH,UH,UW,V,W,Y,Z,ZH
Novel of size 1: -back	AE,EH,ER,EY,IH,IY,Y
Novel of size 3: +consonantal,-nasal,-labiodental	B,CH,D,DH,G,JH,K,L,P,S,SH,T,TH,Z,ZH
Novel of size 3: -consonantal,-labial,-low	AH,EH,ER,EY,IH,IY,Y
Novel of size 2: -continuant,-labial	CH,D,G,JH,K,N,NG,T
Novel of size 2: +consonantal,+anterior	D,DH,L,N,S,T,TH,Z
Novel of size 2: +anterior,-strident	D,DH,ER,L,N,T,TH
Novel of size 3: -labiodental,-coronal,-syllabic	B,G,HH,K,M,NG,P,W,Y
Novel of size 2: -nasal,-strident	D,DH,ER,L,R,T,TH
Novel of size 3: +consonantal,-labiodental,-dorsal	B,CH,D,DH,JH,L,M,N,P,S,SH,T,TH,Z,ZH
Novel of size 2: -strident,-lateral	D,DH,ER,N,R,T,TH
Novel of size 3: +consonantal,-nasal,-dorsal	B,CH,D,DH,F,JH,L,P,S,SH,T,TH,V,Z,ZH
Novel of size 3: -spread_glottis,-round,-lateral	AA,AE,AH,B,CH,D,DH,EH,ER,EY,F,G,IH,IY,JH,K,M,N,NG,P,R,S,SH,T,TH,V,Y,Z,ZH
Novel of size 2: +labial,+tense	OW,UW,W
Novel of size 4: -spread_glottis,-labiodental,-lateral,-dorsal	B,CH,D,DH,JH,M,N,P,R,S,SH,T,TH,Z,ZH
Novel of size 4: -nasal,-spread_glottis,-lateral,-dorsal	B,CH,D,DH,F,JH,P,R,S,SH,T,TH,V,Z,ZH
Novel of size 2: -labiodental,-lateral	AA,AE,AH,AO,B,CH,D,DH,EH,ER,EY,G,HH,IH,IY,JH,K,M,N,NG,OW,P,R,S,SH,T,TH,UH,UW,W,Y,Z,ZH
Novel of size 3: -nasal,+anterior,-lateral	D,DH,ER,S,T,TH,Z
Novel of size 3: -nasal,+voice,-coronal	AA,AE,AH,AO,B,EH,EY,G,IH,IY,OW,UH,UW,V,W,Y
Novel of size 4: -nasal,-spread_glottis,-labial,-syllabic	CH,D,DH,G,JH,K,L,R,S,SH,T,TH,Y,Z,ZH
Novel of size 3: +consonantal,+voice,+distributed	DH,JH,ZH
Novel of size 2: -labial,+high	G,IH,IY,K,NG,Y
Novel of size 5: -nasal,+voice,-round,-labiodental,-coronal	AA,AE,AH,B,EH,EY,G,IH,IY,Y
Novel of size 2: -sonorant,-labial	CH,D,DH,G,HH,JH,K,S,SH,T,TH,Z,ZH
Novel of size 3: -sonorant,-labiodental,-dorsal	B,CH,D,DH,HH,JH,P,S,SH,T,TH,Z,ZH
Novel of size 1: +coronal	CH,D,DH,ER,JH,L,N,R,S,SH,T,TH,Z,ZH
Novel of size 4: -nasal,-spread_glottis,-labial,-coronal	AA,AE,AH,EH,EY,G,IH,IY,K,Y
Novel of size 3: +continuant,+voice,-dorsal	DH,L,R,V,Z,ZH
Novel of size 3: -nasal,+voice,+dorsal	AA,AE,AH,AO,EH,ER,EY,G,IH,IY,OW,UH,UW,W,Y
Novel of size 3: -nasal,-labial,-dorsal	CH,D,DH,HH,JH,L,R,S,SH,T,TH,Z,ZH
Novel of size 3: -labial,-lateral,-dorsal	CH,D,DH,HH,JH,N,R,S,SH,T,TH,Z,ZH
Novel of size 4: +continuant,+voice,-labial,-syllabic	DH,L,R,Y,Z,ZH
Novel of size 4: +continuant,-spread_glottis,-round,-coronal	AA,AE,AH,EH,EY,F,IH,IY,V,Y
Novel of size 2: -nasal,-low	AH,AO,EH,ER,EY,G,IH,IY,K,OW,UH,UW,W,Y
Novel of size 2: -consonantal,+sonorant	AA,AE,AH,AO,EH,ER,EY,IH,IY,OW,R,UH,UW,W,Y
Novel of size 4: +continuant,+voice,+coronal,-lateral	DH,ER,R,Z,ZH
Novel of size 2: -consonantal,-coronal	AA,AE,AH,AO,EH,EY,HH,IH,IY,OW,UH,UW,W,Y
Novel of size 5: +continuant,+voice,-round,-lateral,-syllabic	DH,R,V,Y,Z,ZH
Novel of size 5: +continuant,+voice,-labiodental,-lateral,-syllabic	DH,R,W,Y,Z,ZH
Novel of size 3: -consonantal,-labial,+dorsal	AA,AE,AH,EH,ER,EY,IH,IY,Y
Novel of size 4: -nasal,+voice,-labial,-low	AH,EH,ER,EY,G,IH,IY,Y
Novel of size 3: +continuant,-voice,+coronal	S,SH,TH
Novel of size 3: -round,-coronal,-syllabic	B,F,G,HH,K,M,NG,P,V,Y
Novel of size 2: +consonantal,-sonorant	B,CH,D,DH,F,G,JH,K,P,S,SH,T,TH,V,Z,ZH
Novel of size 1: -strident	D,DH,ER,L,N,R,T,TH
Novel of size 2: -spread_glottis,-round	AA,AE,AH,B,CH,D,DH,EH,ER,EY,F,G,IH,IY,JH,K,L,M,N,NG,P,R,S,SH,T,TH,V,Y,Z,ZH
Novel of size 3: +consonantal,-approximant,-dorsal	B,CH,D,DH,F,JH,M,N,P,S,SH,T,TH,V,Z,ZH
Novel of size 2: -voice,+distributed	CH,SH,TH
Novel of size 3: -spread_glottis,-labiodental,-dorsal	B,CH,D,DH,JH,L,M,N,P,R,S,SH,T,TH,Z,ZH
Novel of size 3: -nasal,-spread_glottis,-dorsal	B,CH,D,DH,F,JH,L,P,R,S,SH,T,TH,V,Z,ZH
Novel of size 4: -nasal,-spread_glottis,-labiodental,-coronal	AA,AE,AH,AO,B,EH,EY,G,IH,IY,K,OW,P,UH,UW,W,Y
Novel of size 1: -labiodental	AA,AE,AH,AO,B,CH,D,DH,EH,ER,EY,G,HH,IH,IY,JH,K,L,M,N,NG,OW,P,R,S,SH,T,TH,UH,UW,W,Y,Z,ZH
Novel of size 6: -nasal,-spread_glottis,-round,-labiodental,-lateral,-syllabic	B,CH,D,DH,G,JH,K,P,R,S,SH,T,TH,Y,Z,ZH
Novel of size 3: +labial,+high,+syllabic	UH,UW
Novel of size 2: -nasal,+anterior	D,DH,ER,L,S,T,TH,Z
Novel of size 2: +anterior,-lateral	D,DH,ER,N,S,T,TH,Z
Novel of size 3: +voice,+distributed,-dorsal	DH,JH,R,ZH
Novel of size 3: -round,-labiodental,-lateral	AA,AE,AH,B,CH,D,DH,EH,ER,EY,G,HH,IH,IY,JH,K,M,N,NG,P,R,S,SH,T,TH,Y,Z,ZH
Novel of size 3: +voice,-labial,-lateral	AA,AE,AH,D,DH,EH,ER,EY,G,IH,IY,JH,N,NG,R,Y,Z,ZH
Novel of size 4: -nasal,-labiodental,-lateral,-dorsal	B,CH,D,DH,HH,JH,P,R,S,SH,T,TH,Z,ZH
Novel of size 4: -nasal,+voice,-round,-coronal	AA,AE,AH,B,EH,EY,G,IH,IY,V,Y
Novel of size 3: +delayed_release,+voice,-labial	DH,JH,Z,ZH
Novel of size 2: -nasal,+dorsal	AA,AE,AH,AO,EH,ER,EY,G,IH,IY,K,OW,UH,UW,W,Y
Novel of size 2: -labial,-dorsal	CH,D,DH,HH,JH,L,N,R,S,SH,T,TH,Z,ZH
Novel of size 1: +approximant	AA,AE,AH,AO,EH,ER,EY,IH,IY,L,OW,R,UH,UW,W,Y
Novel of size 1: -tense	AH,AO,EH,ER,IH,UH
Novel of size 3: +continuant,+voice,+coronal	DH,ER,L,R,Z,ZH
Novel of size 4: +continuant,+voice,-round,-syllabic	DH,L,R,V,Y,Z,ZH
Novel of size 4: +continuant,+voice,-labiodental,-syllabic	DH,L,R,W,Y,Z,ZH
Novel of size 4: -nasal,+voice,-labial,+dorsal	AA,AE,AH,EH,ER,EY,G,IH,IY,Y
Novel of size 3: +consonantal,+continuant,-voice	F,S,SH,TH
Novel of size 4: +continuant,+voice,-lateral,-syllabic	DH,R,V,W,Y,Z,ZH
Novel of size 3: -nasal,-labial,-low	AH,EH,ER,EY,G,IH,IY,K,Y
Novel of size 3: -consonantal,+sonorant,-labial	AA,AE,AH,EH,ER,EY,IH,IY,R,Y
Novel of size 3: -consonantal,-labial,-coronal	AA,AE,AH,EH,EY,HH,IH,IY,Y
Novel of size 2: +consonantal,-nasal	B,CH,D,DH,F,G,JH,K,L,P,S,SH,T,TH,V,Z,ZH
Novel of size 2: -coronal,-syllabic	B,F,G,HH,K,M,NG,P,V,W,Y
Novel of size 3: +voice,-labiodental,-lateral	AA,AE,AH,AO,B,D,DH,EH,ER,EY,G,IH,IY,JH,M,N,NG,OW,R,UH,UW,W,Y,Z,ZH
Novel of size 2: +consonantal,-dorsal	B,CH,D,DH,F,JH,L,M,N,P,S,SH,T,TH,V,Z,ZH
Novel of size 3: -spread_glottis,-lateral,-dorsal	B,CH,D,DH,F,JH,M,N,P,R,S,SH,T,TH,V,Z,ZH
Novel of size 5: -nasal,-spread_glottis,-round,-labiodental,-syllabic	B,CH,D,DH,G,JH,K,L,P,R,S,SH,T,TH,Y,Z,ZH
Novel of size 3: +sonorant,-coronal,-low	AH,AO,EH,EY,IH,IY,NG,OW,UH,UW,W,Y
Novel of size 3: +delayed_release,-voice,+coronal	CH,S,SH,TH
Novel of size 1: -lateral	AA,AE,AH,AO,B,CH,D,DH,EH,ER,EY,F,G,HH,IH,IY,JH,K,M,N,NG,OW,P,R,S,SH,T,TH,UH,UW,V,W,Y,Z,ZH
Novel of size 3: +consonantal,+continuant,-anterior	SH,ZH
Novel of size 1: +anterior	D,DH,ER,L,N,S,T,TH,Z
Novel of size 2: -sonorant,-labiodental	B,CH,D,DH,G,HH,JH,K,P,S,SH,T,TH,Z,ZH
Novel of size 5: -nasal,-spread_glottis,-labiodental,-lateral,-syllabic	B,CH,D,DH,G,JH,K,P,R,S,SH,T,TH,W,Y,Z,ZH
Novel of size 2: +labial,+high	UH,UW,W
Novel of size 3: -sonorant,+voice,+coronal	D,DH,JH,Z,ZH
Novel of size 5: -nasal,-spread_glottis,-round,-labiodental,-coronal	AA,AE,AH,B,EH,EY,G,IH,IY,K,P,Y
Novel of size 2: -round,-labiodental	AA,AE,AH,B,CH,D,DH,EH,ER,EY,G,HH,IH,IY,JH,K,L,M,N,NG,P,R,S,SH,T,TH,Y,Z,ZH
Novel of size 3: -approximant,-labiodental,-dorsal	B,CH,D,DH,HH,JH,M,N,P,S,SH,T,TH,Z,ZH
Novel of size 2: -sonorant,-dorsal	B,CH,D,DH,F,HH,JH,P,S,SH,T,TH,V,Z,ZH
Novel of size 2: +voice,-labial	AA,AE,AH,D,DH,EH,ER,EY,G,IH,IY,JH,L,N,NG,R,Y,Z,ZH
Novel of size 3: -nasal,-labiodental,-dorsal	B,CH,D,DH,HH,JH,L,P,R,S,SH,T,TH,Z,ZH
Novel of size 2: +delayed_release,+voice	DH,JH,V,Z,ZH
Novel of size 4: -nasal,-labial,-lateral,-syllabic	CH,D,DH,G,HH,JH,K,R,S,SH,T,TH,Y,Z,ZH
Novel of size 2: +continuant,-coronal	AA,AE,AH,AO,EH,EY,F,HH,IH,IY,OW,UH,UW,V,W,Y
Novel of size 3: -nasal,-labial,+dorsal	AA,AE,AH,EH,ER,EY,G,IH,IY,K,Y
Novel of size 3: +continuant,+voice,-syllabic	DH,L,R,V,W,Y,Z,ZH
Novel of size 1: -continuant	B,CH,D,G,JH,K,M,N,NG,P,T
Novel of size 2: +approximant,-labial	AA,AE,AH,EH,ER,EY,IH,IY,L,R,Y
Novel of size 2: +voice,-labiodental	AA,AE,AH,AO,B,D,DH,EH,ER,EY,G,IH,IY,JH,L,M,N,NG,OW,R,UH,UW,W,Y,Z,ZH
Novel of size 3: +sonorant,-coronal,+dorsal	AA,AE,AH,AO,EH,EY,IH,IY,NG,OW,UH,UW,W,Y
Novel of size 3: +consonantal,+delayed_release,-voice	CH,F,S,SH,TH
Novel of size 3: +voice,-coronal,-low	AH,AO,EH,EY,G,IH,IY,NG,OW,UH,UW,W,Y
Novel of size 2: -spread_glottis,-dorsal	B,CH,D,DH,F,JH,L,M,N,P,R,S,SH,T,TH,V,Z,ZH
Novel of size 2: +voice,-lateral	AA,AE,AH,AO,B,D,DH,EH,ER,EY,G,IH,IY,JH,M,N,NG,OW,R,UH,UW,V,W,Y,Z,ZH
Novel of size 3: -nasal,-spread_glottis,-coronal	AA,AE,AH,AO,B,EH,EY,F,G,IH,IY,K,OW,P,UH,UW,V,W,Y
Novel of size 5: -nasal,-spread_glottis,-round,-lateral,-syllabic	B,CH,D,DH,F,G,JH,K,P,R,S,SH,T,TH,V,Y,Z,ZH
Novel of size 4: -sonorant,+voice,-labiodental,-dorsal	B,D,DH,JH,Z,ZH
Novel of size 4: +voice,-round,-labiodental,-lateral	AA,AE,AH,B,D,DH,EH,ER,EY,G,IH,IY,JH,M,N,NG,R,Y,Z,ZH
Novel of size 2: +continuant,-anterior	R,SH,ZH
Novel of size 2: -voice,+coronal	CH,S,SH,T,TH
Novel of size 3: -sonorant,+voice,-labial	D,DH,G,JH,Z,ZH
Novel of size 4: -nasal,-spread_glottis,-labiodental,-syllabic	B,CH,D,DH,G,JH,K,L,P,R,S,SH,T,TH,W,Y,Z,ZH
Novel of size 4: +consonantal,-nasal,+voice,+coronal	D,DH,JH,L,Z,ZH
Novel of size 3: -approximant,+voice,+coronal	D,DH,JH,N,Z,ZH
Novel of size 4: +sonorant,-labial,-coronal,-low	AH,EH,EY,IH,IY,NG,Y
Novel of size 2: -round,-lateral	AA,AE,AH,B,CH,D,DH,EH,ER,EY,F,G,HH,IH,IY,JH,K,M,N,NG,P,R,S,SH,T,TH,V,Y,Z,ZH
Novel of size 5: -nasal,+voice,-labial,-lateral,-dorsal	D,DH,JH,R,Z,ZH
Novel of size 3: -labiodental,-lateral,-dorsal	B,CH,D,DH,HH,JH,M,N,P,R,S,SH,T,TH,Z,ZH
Novel of size 3: -nasal,-lateral,-dorsal	B,CH,D,DH,F,HH,JH,P,R,S,SH,T,TH,V,Z,ZH
Novel of size 3: -nasal,-labial,-syllabic	CH,D,DH,G,HH,JH,K,L,R,S,SH,T,TH,Y,Z,ZH
Novel of size 2: +voice,+distributed	DH,ER,JH,R,ZH
Novel of size 3: +consonantal,-approximant,-labial	CH,D,DH,G,JH,K,N,NG,S,SH,T,TH,Z,ZH
Novel of size 3: -nasal,-labial,-coronal	AA,AE,AH,EH,EY,G,HH,IH,IY,K,Y
Novel of size 3: +continuant,-round,-coronal	AA,AE,AH,EH,EY,F,HH,IH,IY,V,Y
Novel of size 1: -consonantal	AA,AE,AH,AO,EH,ER,EY,HH,IH,IY,OW,R,UH,UW,W,Y
Novel of size 3: +voice,-coronal,+dorsal	AA,AE,AH,AO,EH,EY,G,IH,IY,NG,OW,UH,UW,W,Y
Novel of size 2: +sonorant,-coronal	AA,AE,AH,AO,EH,EY,IH,IY,M,NG,OW,UH,UW,W,Y
Novel of size 2: -coronal,-low	AH,AO,EH,EY,G,IH,IY,K,NG,OW,UH,UW,W,Y
Novel of size 3: -sonorant,+voice,-labiodental	B,D,DH,G,JH,Z,ZH
Novel of size 1: +voice	AA,AE,AH,AO,B,D,DH,EH,ER,EY,G,IH,IY,JH,L,M,N,NG,OW,R,UH,UW,V,W,Y,Z,ZH
Novel of size 4: -nasal,-spread_glottis,-round,-syllabic	B,CH,D,DH,F,G,JH,K,L,P,R,S,SH,T,TH,V,Y,Z,ZH
Novel of size 3: +continuant,-voice,-labial	HH,S,SH,TH
Novel of size 5: +consonantal,-nasal,+voice,-labiodental,-dorsal	B,D,DH,JH,L,Z,ZH
Novel of size 3: +consonantal,-voice,-labial	CH,K,S,SH,T,TH
Novel of size 3: +voice,-round,-labiodental	AA,AE,AH,B,D,DH,EH,ER,EY,G,IH,IY,JH,L,M,N,NG,R,Y,Z,ZH
Novel of size 4: +consonantal,-nasal,+voice,-labial	D,DH,G,JH,L,Z,ZH
Novel of size 5: -nasal,+voice,-labiodental,-lateral,-dorsal	B,D,DH,JH,R,Z,ZH
Novel of size 1: -sonorant	B,CH,D,DH,F,G,HH,JH,K,P,S,SH,T,TH,V,Z,ZH
Novel of size 3: +sonorant,-labial,-coronal	AA,AE,AH,EH,EY,IH,IY,NG,Y
Novel of size 4: +consonantal,-voice,-labiodental,-dorsal	CH,P,S,SH,T,TH
Novel of size 4: -nasal,-spread_glottis,-lateral,-syllabic	B,CH,D,DH,F,G,JH,K,P,R,S,SH,T,TH,V,W,Y,Z,ZH
Novel of size 3: -sonorant,+voice,-dorsal	B,D,DH,JH,V,Z,ZH
Novel of size 4: +voice,-labial,-coronal,-low	AH,EH,EY,G,IH,IY,NG,Y
Novel of size 3: +consonantal,+voice,+coronal	D,DH,JH,L,N,Z,ZH
Novel of size 3: +voice,-round,-lateral	AA,AE,AH,B,D,DH,EH,ER,EY,G,IH,IY,JH,M,N,NG,R,V,Y,Z,ZH
Novel of size 4: -nasal,-spread_glottis,-round,-coronal	AA,AE,AH,B,EH,EY,F,G,IH,IY,K,P,V,Y
Novel of size 1: -round	AA,AE,AH,B,CH,D,DH,EH,ER,EY,F,G,HH,IH,IY,JH,K,L,M,N,NG,P,R,S,SH,T,TH,V,Y,Z,ZH
Novel of size 2: -approximant,-dorsal	B,CH,D,DH,F,HH,JH,M,N,P,S,SH,T,TH,V,Z,ZH
Novel of size 4: -nasal,+voice,-labial,-dorsal	D,DH,JH,L,R,Z,ZH
Novel of size 2: +sonorant,-low	AH,AO,EH,ER,EY,IH,IY,NG,OW,UH,UW,W,Y
Novel of size 2: -labiodental,-dorsal	B,CH,D,DH,HH,JH,L,M,N,P,R,S,SH,T,TH,Z,ZH
Novel of size 4: +voice,-labial,-lateral,-dorsal	D,DH,JH,N,R,Z,ZH
Novel of size 2: -nasal,-dorsal	B,CH,D,DH,F,HH,JH,L,P,R,S,SH,T,TH,V,Z,ZH
Novel of size 2: +continuant,+strident	S,SH,Z,ZH
Novel of size 3: -nasal,-labiodental,-coronal	AA,AE,AH,AO,B,EH,EY,G,HH,IH,IY,K,OW,P,UH,UW,W,Y
Novel of size 5: -nasal,-round,-labiodental,-lateral,-syllabic	B,CH,D,DH,G,HH,JH,K,P,R,S,SH,T,TH,Y,Z,ZH
Novel of size 4: +continuant,-spread_glottis,-labiodental,-lateral	AA,AE,AH,AO,DH,EH,ER,EY,IH,IY,OW,R,S,SH,TH,UH,UW,W,Y,Z,ZH
Novel of size 2: +consonantal,-labial	CH,D,DH,G,JH,K,L,N,NG,S,SH,T,TH,Z,ZH
Novel of size 2: -coronal,+dorsal	AA,AE,AH,AO,EH,EY,G,IH,IY,K,NG,OW,UH,UW,W,Y
Novel of size 2: +continuant,-voice	F,HH,S,SH,TH
Novel of size 4: +consonantal,-nasal,+voice,-labiodental	B,D,DH,G,JH,L,Z,ZH
Novel of size 2: -consonantal,-labial	AA,AE,AH,EH,ER,EY,HH,IH,IY,R,Y
Novel of size 3: +voice,-labial,-coronal	AA,AE,AH,EH,EY,G,IH,IY,NG,Y
Novel of size 3: +consonantal,-voice,-dorsal	CH,F,P,S,SH,T,TH
Novel of size 4: -approximant,+voice,-labiodental,-dorsal	B,D,DH,JH,M,N,Z,ZH
Novel of size 2: -sonorant,+voice	B,D,DH,G,JH,V,Z,ZH
Novel of size 2: +tense,+syllabic	EY,IY,OW,UW
Novel of size 4: -nasal,+voice,-labiodental,-dorsal	B,D,DH,JH,L,R,Z,ZH
Novel of size 3: +consonantal,-voice,-labiodental	CH,K,P,S,SH,T,TH
Novel of size 3: +sonorant,-round,-coronal	AA,AE,AH,EH,EY,IH,IY,M,NG,Y
Novel of size 3: -nasal,-spread_glottis,-syllabic	B,CH,D,DH,F,G,JH,K,L,P,R,S,SH,T,TH,V,W,Y,Z,ZH
Novel of size 3: -labial,-coronal,-low	AH,EH,EY,G,IH,IY,K,NG,Y
Novel of size 2: +sonorant,+dorsal	AA,AE,AH,AO,EH,ER,EY,IH,IY,NG,OW,UH,UW,W,Y
Novel of size 4: +consonantal,-nasal,+voice,-dorsal	B,D,DH,JH,L,V,Z,ZH
Novel of size 2: +voice,-low	AH,AO,EH,ER,EY,G,IH,IY,NG,OW,UH,UW,W,Y
Novel of size 2: +voice,-round	AA,AE,AH,B,D,DH,EH,ER,EY,G,IH,IY,JH,L,M,N,NG,R,V,Y,Z,ZH
Novel of size 4: -nasal,+voice,-lateral,-dorsal	B,D,DH,JH,R,V,Z,ZH
Novel of size 3: +voice,-labial,-dorsal	D,DH,JH,L,N,R,Z,ZH
Novel of size 2: -lateral,-dorsal	B,CH,D,DH,F,HH,JH,M,N,P,R,S,SH,T,TH,V,Z,ZH
Novel of size 4: -nasal,-round,-labiodental,-syllabic	B,CH,D,DH,G,HH,JH,K,L,P,R,S,SH,T,TH,Y,Z,ZH
Novel of size 3: +continuant,-spread_glottis,-labiodental	AA,AE,AH,AO,DH,EH,ER,EY,IH,IY,L,OW,R,S,SH,TH,UH,UW,W,Y,Z,ZH
Novel of size 5: -nasal,+voice,-labial,-lateral,-syllabic	D,DH,G,JH,R,Y,Z,ZH
Novel of size 3: +delayed_release,-voice,-labial	CH,HH,S,SH,TH
Novel of size 4: -nasal,-labiodental,-lateral,-syllabic	B,CH,D,DH,G,HH,JH,K,P,R,S,SH,T,TH,W,Y,Z,ZH
Novel of size 3: +sonorant,-labial,-low	AH,EH,ER,EY,IH,IY,NG,Y
Novel of size 4: -nasal,+voice,+coronal,-lateral	D,DH,ER,JH,R,Z,ZH
Novel of size 4: -nasal,-round,-labiodental,-coronal	AA,AE,AH,B,EH,EY,G,HH,IH,IY,K,P,Y
Novel of size 4: +continuant,-spread_glottis,-labial,-lateral	AA,AE,AH,DH,EH,ER,EY,IH,IY,R,S,SH,TH,Y,Z,ZH
Novel of size 3: +voice,-labiodental,-coronal	AA,AE,AH,AO,B,EH,EY,G,IH,IY,M,NG,OW,UH,UW,W,Y
Novel of size 4: -spread_glottis,-labial,-lateral,-syllabic	CH,D,DH,G,JH,K,N,NG,R,S,SH,T,TH,Y,Z,ZH
Novel of size 3: -spread_glottis,-labial,-coronal	AA,AE,AH,EH,EY,G,IH,IY,K,NG,Y
Novel of size 2: +consonantal,-voice	CH,F,K,P,S,SH,T,TH
Novel of size 4: +consonantal,+voice,-labiodental,-dorsal	B,D,DH,JH,L,M,N,Z,ZH
Novel of size 2: +voice,+dorsal	AA,AE,AH,AO,EH,ER,EY,G,IH,IY,NG,OW,UH,UW,W,Y
Novel of size 3: +consonantal,-nasal,+voice	B,D,DH,G,JH,L,V,Z,ZH
Novel of size 4: +voice,-labiodental,-lateral,-dorsal	B,D,DH,JH,M,N,R,Z,ZH
Novel of size 1: -low	AH,AO,EH,ER,EY,G,IH,IY,K,NG,OW,UH,UW,W,Y
Novel of size 3: -approximant,+voice,-dorsal	B,D,DH,JH,M,N,V,Z,ZH
Novel of size 6: -nasal,+voice,-round,-labiodental,-lateral,-syllabic	B,D,DH,G,JH,R,Y,Z,ZH
Novel of size 3: -nasal,+voice,-dorsal	B,D,DH,JH,L,R,V,Z,ZH
Novel of size 2: +delayed_release,-voice	CH,F,HH,S,SH,TH
Novel of size 1: -dorsal	B,CH,D,DH,F,HH,JH,L,M,N,P,R,S,SH,T,TH,V,Z,ZH
Novel of size 2: -nasal,-coronal	AA,AE,AH,AO,B,EH,EY,F,G,HH,IH,IY,K,OW,P,UH,UW,V,W,Y
Novel of size 4: -nasal,+voice,-labial,-syllabic	D,DH,G,JH,L,R,Y,Z,ZH
Novel of size 4: -nasal,-round,-lateral,-syllabic	B,CH,D,DH,F,G,HH,JH,K,P,R,S,SH,T,TH,V,Y,Z,ZH
Novel of size 3: +continuant,-spread_glottis,-lateral	AA,AE,AH,AO,DH,EH,ER,EY,F,IH,IY,OW,R,S,SH,TH,UH,UW,V,W,Y,Z,ZH
Novel of size 3: +sonorant,-labial,+dorsal	AA,AE,AH,EH,ER,EY,IH,IY,NG,Y
Novel of size 3: +voice,-labial,-low	AH,EH,ER,EY,G,IH,IY,NG,Y
Novel of size 3: -nasal,-labiodental,-syllabic	B,CH,D,DH,G,HH,JH,K,L,P,R,S,SH,T,TH,W,Y,Z,ZH
Novel of size 3: -voice,-labial,-dorsal	CH,HH,S,SH,T,TH
Novel of size 3: -nasal,+voice,+coronal	D,DH,ER,JH,L,R,Z,ZH
Novel of size 3: +consonantal,-approximant,-labiodental	B,CH,D,DH,G,JH,K,M,N,NG,P,S,SH,T,TH,Z,ZH
Novel of size 3: +voice,+coronal,-lateral	D,DH,ER,JH,N,R,Z,ZH
Novel of size 3: +continuant,-spread_glottis,-labial	AA,AE,AH,DH,EH,ER,EY,IH,IY,L,R,S,SH,TH,Y,Z,ZH
Novel of size 2: +voice,-coronal	AA,AE,AH,AO,B,EH,EY,G,IH,IY,M,NG,OW,UH,UW,V,W,Y
Novel of size 3: -spread_glottis,-labial,-syllabic	CH,D,DH,G,JH,K,L,N,NG,R,S,SH,T,TH,Y,Z,ZH
Novel of size 4: +voice,-round,-labiodental,-coronal	AA,AE,AH,B,EH,EY,G,IH,IY,M,NG,Y
Novel of size 2: -approximant,-labial	CH,D,DH,G,HH,JH,K,N,NG,S,SH,T,TH,Z,ZH
Novel of size 1: +dorsal	AA,AE,AH,AO,EH,ER,EY,G,IH,IY,K,NG,OW,UH,UW,W,Y
Novel of size 3: +voice,-labiodental,-dorsal	B,D,DH,JH,L,M,N,R,Z,ZH
Novel of size 3: +consonantal,+voice,-dorsal	B,D,DH,JH,L,M,N,V,Z,ZH
Novel of size 5: -nasal,+voice,-round,-labiodental,-syllabic	B,D,DH,G,JH,L,R,Y,Z,ZH
Novel of size 3: +voice,-lateral,-dorsal	B,D,DH,JH,M,N,R,V,Z,ZH
Novel of size 3: +voice,-labial,+dorsal	AA,AE,AH,EH,ER,EY,G,IH,IY,NG,Y
Novel of size 5: -nasal,+voice,-round,-lateral,-syllabic	B,D,DH,G,JH,R,V,Y,Z,ZH
Novel of size 5: -nasal,+voice,-labiodental,-lateral,-syllabic	B,D,DH,G,JH,R,W,Y,Z,ZH
Novel of size 3: -nasal,-round,-syllabic	B,CH,D,DH,F,G,HH,JH,K,L,P,R,S,SH,T,TH,V,Y,Z,ZH
Novel of size 2: +continuant,-spread_glottis	AA,AE,AH,AO,DH,EH,ER,EY,F,IH,IY,L,OW,R,S,SH,TH,UH,UW,V,W,Y,Z,ZH
Novel of size 1: +tense	EY,IY,OW,UW,W,Y
Novel of size 2: -labial,-low	AH,EH,ER,EY,G,IH,IY,K,NG,Y
Novel of size 2: -voice,-labial	CH,HH,K,S,SH,T,TH
Novel of size 3: -nasal,-lateral,-syllabic	B,CH,D,DH,F,G,HH,JH,K,P,R,S,SH,T,TH,V,W,Y,Z,ZH
Novel of size 3: -voice,-labiodental,-dorsal	CH,HH,P,S,SH,T,TH
Novel of size 2: +consonantal,-anterior	CH,JH,SH,ZH
Novel of size 2: +consonantal,-labiodental	B,CH,D,DH,G,JH,K,L,M,N,NG,P,S,SH,T,TH,Z,ZH
Novel of size 2: +voice,+coronal	D,DH,ER,JH,L,N,R,Z,ZH
Novel of size 3: -nasal,-round,-coronal	AA,AE,AH,B,EH,EY,F,G,HH,IH,IY,K,P,V,Y
Novel of size 4: +continuant,-spread_glottis,-round,-lateral	AA,AE,AH,DH,EH,ER,EY,F,IH,IY,R,S,SH,TH,V,Y,Z,ZH
Novel of size 3: +continuant,-labiodental,-lateral	AA,AE,AH,AO,DH,EH,ER,EY,HH,IH,IY,OW,R,S,SH,TH,UH,UW,W,Y,Z,ZH
Novel of size 3: -spread_glottis,-labiodental,-coronal	AA,AE,AH,AO,B,EH,EY,G,IH,IY,K,M,NG,OW,P,UH,UW,W,Y
Novel of size 2: +labial,+syllabic	AO,OW,UH,UW
Novel of size 3: +voice,-round,-coronal	AA,AE,AH,B,EH,EY,G,IH,IY,M,NG,V,Y
Novel of size 2: +sonorant,-lateral	AA,AE,AH,AO,EH,ER,EY,IH,IY,M,N,NG,OW,R,UH,UW,W,Y
Novel of size 2: +voice,-dorsal	B,D,DH,JH,L,M,N,R,V,Z,ZH
Novel of size 2: -labial,+dorsal	AA,AE,AH,EH,ER,EY,G,IH,IY,K,NG,Y
Novel of size 4: -nasal,+voice,-round,-syllabic	B,D,DH,G,JH,L,R,V,Y,Z,ZH
Novel of size 4: -nasal,+voice,-labiodental,-syllabic	B,D,DH,G,JH,L,R,W,Y,Z,ZH
Novel of size 2: -voice,-dorsal	CH,F,HH,P,S,SH,T,TH
Novel of size 4: -nasal,+voice,-lateral,-syllabic	B,D,DH,G,JH,R,V,W,Y,Z,ZH
Novel of size 2: -voice,-labiodental	CH,HH,K,P,S,SH,T,TH
Novel of size 3: +sonorant,-labial,-lateral	AA,AE,AH,EH,ER,EY,IH,IY,N,NG,R,Y
Novel of size 2: -nasal,-syllabic	B,CH,D,DH,F,G,HH,JH,K,L,P,R,S,SH,T,TH,V,W,Y,Z,ZH
Novel of size 3: -low,+back,+syllabic	AH,AO,OW,UH,UW
Novel of size 2: +consonantal,-approximant	B,CH,D,DH,F,G,JH,K,M,N,NG,P,S,SH,T,TH,V,Z,ZH
Novel of size 1: -anterior	CH,JH,R,SH,ZH
Novel of size 3: +continuant,-spread_glottis,-round	AA,AE,AH,DH,EH,ER,EY,F,IH,IY,L,R,S,SH,TH,V,Y,Z,ZH
Novel of size 2: +continuant,-labiodental	AA,AE,AH,AO,DH,EH,ER,EY,HH,IH,IY,L,OW,R,S,SH,TH,UH,UW,W,Y,Z,ZH
Novel of size 2: +high,+syllabic	IH,IY,UH,UW
Novel of size 5: -spread_glottis,-round,-labiodental,-lateral,-syllabic	B,CH,D,DH,G,JH,K,M,N,NG,P,R,S,SH,T,TH,Y,Z,ZH
Novel of size 3: +continuant,-labial,-lateral	AA,AE,AH,DH,EH,ER,EY,HH,IH,IY,R,S,SH,TH,Y,Z,ZH
Novel of size 2: +back,+syllabic	AA,AH,AO,OW,UH,UW
Novel of size 4: -spread_glottis,-round,-labiodental,-coronal	AA,AE,AH,B,EH,EY,G,IH,IY,K,M,NG,P,Y
Novel of size 1: +round	AO,OW,UH,UW,W
Novel of size 3: -labial,-lateral,-syllabic	CH,D,DH,G,HH,JH,K,N,NG,R,S,SH,T,TH,Y,Z,ZH
Novel of size 1: +sonorant	AA,AE,AH,AO,EH,ER,EY,IH,IY,L,M,N,NG,OW,R,UH,UW,W,Y
Novel of size 2: -labial,-coronal	AA,AE,AH,EH,EY,G,HH,IH,IY,K,NG,Y
Novel of size 1: -voice	CH,F,HH,K,P,S,SH,T,TH
Novel of size 3: -nasal,+voice,-syllabic	B,D,DH,G,JH,L,R,V,W,Y,Z,ZH
Novel of size 2: +sonorant,-labial	AA,AE,AH,EH,ER,EY,IH,IY,L,N,NG,R,Y
Novel of size 3: +sonorant,-round,-lateral	AA,AE,AH,EH,ER,EY,IH,IY,M,N,NG,R,Y
Novel of size 1: +consonantal	B,CH,D,DH,F,G,JH,K,L,M,N,NG,P,S,SH,T,TH,V,Z,ZH
Novel of size 2: -low,+back	AH,AO,OW,UH,UW,W
Novel of size 2: +continuant,-lateral	AA,AE,AH,AO,DH,EH,ER,EY,F,HH,IH,IY,OW,R,S,SH,TH,UH,UW,V,W,Y,Z,ZH
Novel of size 2: -spread_glottis,-coronal	AA,AE,AH,AO,B,EH,EY,F,G,IH,IY,K,M,NG,OW,P,UH,UW,V,W,Y
Novel of size 4: -spread_glottis,-round,-labiodental,-syllabic	B,CH,D,DH,G,JH,K,L,M,N,NG,P,R,S,SH,T,TH,Y,Z,ZH
Novel of size 1: +strident	CH,JH,S,SH,Z,ZH
Novel of size 2: -approximant,-labiodental	B,CH,D,DH,G,HH,JH,K,M,N,NG,P,S,SH,T,TH,Z,ZH
Novel of size 3: -approximant,+voice,-labial	D,DH,G,JH,N,NG,Z,ZH
Novel of size 2: +continuant,-labial	AA,AE,AH,DH,EH,ER,EY,HH,IH,IY,L,R,S,SH,TH,Y,Z,ZH
Novel of size 4: -spread_glottis,-labiodental,-lateral,-syllabic	B,CH,D,DH,G,JH,K,M,N,NG,P,R,S,SH,T,TH,W,Y,Z,ZH
Novel of size 4: -nasal,+voice,+labial,-labiodental	AO,B,OW,UH,UW,W
Novel of size 1: +back	AA,AH,AO,OW,UH,UW,W
Novel of size 2: +sonorant,+labial	AO,M,OW,UH,UW,W
Novel of size 2: -labial,-syllabic	CH,D,DH,G,HH,JH,K,L,N,NG,R,S,SH,T,TH,Y,Z,ZH
Novel of size 3: +continuant,+voice,+labial	AO,OW,UH,UW,V,W
